F
10
10
AAAAAAAAAA
A E @    A
AAAAA    A
A    3   A
A    2   A
A    2   A
A    3   A
A        A
A        A
AAAAAAAAAA