J
10
10
AAAAAAAAAA
A E      A
AAAAA    A
A    M   A
A  @MSM  A
A   MSM  A
A   MSMS A
A   MSMS A
A   SMSS A
AAAAAGAAAA