J
10
10
AAAAAAAAAA
A E      A
AAAAA    A
A        A
A  @XSX  A
A   XSX  A
A   XSX  A
A   XSX  A
A        A
AAAAAAAAAA