F
10
10
AAAAAAAAAA
A E @    A
AAAAA    A
A        A
A        A
A        A
A        A
A        A
A        A
AAAAAAAAAA